"a" = (/turf/open/floor/rogue/grass,/area/rogue/outdoors/bog)
"b" = (/turf/open/floor/rogue/dirt,/area/rogue/outdoors/bog)
"c" = (/obj/item/natural/stone,/turf/open/floor/rogue/grass,/area/rogue/outdoors/bog)
"d" = (/obj/effect/decal/remains/saiga,/turf/open/floor/rogue/grass,/area/rogue/outdoors/bog)
"e" = (/obj/structure/flora/roguegrass/bush,/turf/open/floor/rogue/dirt,/area/rogue/outdoors/bog)
"f" = (/turf/closed/wall/mineral/rogue/wood,/area/rogue/indoors/shelter/bog)
"g" = (/obj/machinery/light/rogue/campfire,/turf/open/floor/rogue/grass,/area/rogue/outdoors/bog)
"h" = (/obj/structure/table/wood{icon_state = "tablewood1"},/obj/effect/decal/cleanable/cobweb,/turf/open/floor/rogue/ruinedwood{icon_state = "weird1"},/area/rogue/indoors/shelter/bog)
"i" = (/obj/structure/chair/wood/rogue/chair3{dir = 8},/turf/open/floor/rogue/ruinedwood{icon_state = "weird1"},/area/rogue/indoors/shelter/bog)
"j" = (/obj/structure/chair/wood/rogue/chair3{dir = 1},/turf/open/floor/rogue/ruinedwood{icon_state = "weird1"},/area/rogue/indoors/shelter/bog)
"k" = (/turf/open/floor/rogue/ruinedwood{icon_state = "weird1"},/area/rogue/indoors/shelter/bog)
"l" = (/obj/structure/mineral_door/wood{locked = 1; lockid = "mason"},/turf/open/floor/rogue/ruinedwood{icon_state = "weird1"},/area/rogue/indoors/shelter/bog)
"m" = (/obj/structure/flora/roguegrass,/turf/open/floor/rogue/dirt,/area/rogue/outdoors/bog)
"n" = (/obj/effect/decal/remains/human,/turf/open/floor/rogue/ruinedwood{icon_state = "weird1"},/area/rogue/indoors/shelter/bog)
"o" = (/obj/effect/decal/cleanable/blood,/turf/open/floor/rogue/ruinedwood{icon_state = "weird1"},/area/rogue/indoors/shelter/bog)
"p" = (/obj/machinery/light/rogue/hearth,/obj/effect/decal/cleanable/cobweb{icon_state = "cobweb2"},/turf/open/floor/rogue/ruinedwood{icon_state = "weird1"},/area/rogue/indoors/shelter/bog)
"q" = (/obj/structure/closet/crate/roguecloset,/obj/item/natural/bundle/fibers,/obj/item/natural/hide,/turf/open/floor/rogue/ruinedwood{icon_state = "weird1"},/area/rogue/indoors/shelter/bog)
"r" = (/obj/structure/closet/crate/chest,/obj/item/reagent_containers/food/snacks/rogue/crackerscooked,/turf/open/floor/rogue/ruinedwood{icon_state = "weird1"},/area/rogue/indoors/shelter/bog)
"s" = (/obj/structure/bed/rogue/shit,/turf/open/floor/rogue/ruinedwood{icon_state = "weird1"},/area/rogue/indoors/shelter/bog)
"t" = (/turf/open/transparent/openspace,/area/rogue/outdoors/bog)
"u" = (/turf/open/transparent/openspace,/turf/open/transparent/openspace,/area/rogue/outdoors/bog)
"v" = (/turf/open/floor/rogue/ruinedwood{icon_state = "vertw"},/area/rogue/outdoors/bog)
"w" = (/obj/effect/decal/remains/human,/turf/open/floor/rogue/ruinedwood{icon_state = "vertw"},/area/rogue/outdoors/bog)
"x" = (/obj/effect/decal/cleanable/vomit/old,/turf/open/floor/rogue/ruinedwood{icon_state = "vertw"},/area/rogue/outdoors/bog)
"y" = (/turf/open/floor/rogue/metal{icon_state = "plating2"},/area/rogue/outdoors/bog)

(1,1,1) = {"
abbbaaaabb
acabbbbdab
aaefffbaga
bafhiffaab
aafjkklbaa
bmfkkkffba
bbfnokpfba
bafqrksfeb
aamffffaab
babaabaaab
"}

(1,1,2) = {"
tttttttttt
tttttttttt
uuuvvvtttt
ttvvvvvttt
ttvvvvvttt
ttvvvwvvtt
ttvvxvyvtt
ttvvvvvvtt
tttvvvvttt
tttttttttt
"}
