"a" = (/obj/structure/table/reinforced,/obj/item/t_scanner,/obj/item/gun/ballistic/revolver/last_resort,/turf/open/floor/plasteel/maniac/damaged,/area/rogue/underworld)
"b" = (/turf/open/floor/plating/dirt/dark,/area/rogue/underworld)
"c" = (/obj/effect/landmark/underworldsafe,/turf/open/floor/plating/dirt/dark,/area/rogue/underworld)
"d" = (/obj/structure/underworld/barrier,/turf/open/floor/plating/dirt/dark,/area/rogue/underworld)
"e" = (/turf/open/floor/rogue/underworld/road,/area/rogue/underworld)
"f" = (/obj/structure/underworld/barrier,/turf/open/floor/rogue/churchrough,/area/rogue/underworld)
"g" = (/obj/structure/underworld/barrier,/turf/open/floor/rogue/underworld/road,/area/rogue/underworld)
"h" = (/obj/machinery/light/rogue/campfire/densefire{fueluse = 1800000},/turf/open/floor/rogue/underworld/road,/area/rogue/underworld)
"i" = (/obj/effect/landmark/underworld,/turf/open/floor/rogue/underworld/road,/area/rogue/underworld)
"j" = (/obj/structure/underworld/carriage{pixel_x = -100},/turf/open/floor/rogue/churchrough,/area/rogue/underworld)
"k" = (/turf/open/floor/rogue/churchrough,/area/rogue/underworld)
"l" = (/obj/effect/landmark/underworldsafe,/turf/open/floor/rogue/underworld/road,/area/rogue/underworld)
"n" = (/obj/structure/flora/roguetree/underworld,/turf/open/floor/rogue/underworld/road,/area/rogue/underworld)
"o" = (/obj/effect/landmark/underworldcoin,/turf/open/floor/rogue/underworld/road,/area/rogue/underworld)
"p" = (/obj/structure/underworld/carriageman{pixel_x = -15; pixel_y = -20},/turf/open/floor/rogue/churchrough,/area/rogue/underworld)
"r" = (/obj/machinery/telecomms/server{name = "cyberspace server"},/turf/open/floor/plasteel/maniac/damaged,/area/rogue/underworld)
"s" = (/obj/structure/cable,/turf/open/floor/plasteel/maniac/damaged,/area/rogue/underworld)
"t" = (/turf/closed/wall/mineral/rogue/pipe{dir = 1; icon_state = "iron_corner"},/area/rogue/underworld)
"u" = (/obj/structure/disposalpipe/segment{dir = 8},/obj/item/paper/fluff,/turf/open/floor/plasteel/maniac/damaged,/area/rogue/underworld)
"v" = (/obj/structure/stairs{dir = 1; icon_state = "stairs"},/obj/item/paper/fluff,/turf/open/floor/plasteel/maniac/damaged,/area/rogue/underworld)
"w" = (/turf/closed/wall/mineral/rogue/pipe{dir = 8; icon_state = "iron_corner"},/area/rogue/underworld)
"y" = (/obj/machinery/light/small{dir = 8},/turf/open/floor/plasteel/maniac/damaged,/area/rogue/underworld)
"z" = (/obj/structure/disposalpipe/junction/yjunction,/turf/open/floor/plasteel/maniac/damaged,/area/rogue/underworld)
"A" = (/obj/structure/chair/wood/rogue/throne{name = "cyberthrone"},/obj/effect/landmark/treyliam,/turf/open/floor/plasteel/maniac/damaged,/area/rogue/underworld)
"B" = (/turf/closed/wall/mineral/rogue/pipe{dir = 4; icon_state = "iron_line"},/area/rogue/underworld)
"C" = (/obj/structure/disposalpipe/broken{dir = 4},/turf/open/floor/rogue/underworld/road,/area/rogue/underworld)
"D" = (/obj/structure/cable,/obj/item/paper/fluff,/turf/open/floor/plasteel/maniac/damaged,/area/rogue/underworld)
"E" = (/obj/machinery/computer{dir = 8},/turf/open/floor/plasteel/maniac/damaged,/area/rogue/underworld)
"G" = (/obj/machinery/blackbox_recorder,/obj/structure/cable,/turf/open/floor/plasteel/maniac/damaged,/area/rogue/underworld)
"H" = (/obj/item/paper/fluff,/obj/machinery/light/small{dir = 4},/turf/open/floor/plasteel/maniac/damaged,/area/rogue/underworld)
"I" = (/turf/closed/wall/mineral/rogue/pipe{icon_state = "iron_corner"},/area/rogue/underworld)
"K" = (/obj/machinery/computer{dir = 8},/obj/structure/disposalpipe/segment{dir = 8},/turf/open/floor/plasteel/maniac/damaged,/area/rogue/underworld)
"L" = (/obj/structure/disposalpipe/broken{dir = 1},/turf/open/floor/rogue/underworld/road,/area/rogue/underworld)
"N" = (/turf/closed/wall/mineral/rogue/pipe{dir = 4; icon_state = "iron_corner"},/area/rogue/underworld)
"O" = (/obj/structure/cable_bridge,/turf/open/floor/plasteel/maniac/damaged,/area/rogue/underworld)
"P" = (/turf/closed/wall/mineral/rogue/pipe{icon_state = "iron_line"},/area/rogue/underworld)
"Q" = (/obj/structure/stairs{dir = 1; icon_state = "stairs"},/turf/open/floor/plasteel/maniac/damaged,/area/rogue/underworld)
"R" = (/obj/machinery/light/small,/turf/open/floor/plasteel/maniac/damaged,/area/rogue/underworld)
"S" = (/obj/machinery/computer{dir = 4},/obj/structure/disposalpipe/segment{dir = 8},/turf/open/floor/plasteel/maniac/damaged,/area/rogue/underworld)
"T" = (/obj/structure/disposalpipe/segment{dir = 8},/turf/closed/wall/mineral/rogue/pipe{icon_state = "iron_line"},/area/rogue/underworld)
"U" = (/obj/item/paper/fluff,/obj/machinery/light/small,/turf/open/floor/plasteel/maniac/damaged,/area/rogue/underworld)
"V" = (/obj/structure/disposalpipe/segment,/turf/open/floor/plasteel/maniac/damaged,/area/rogue/underworld)
"W" = (/obj/machinery/door/airlock/maniac,/turf/open/floor/plasteel/maniac,/area/rogue/underworld)
"X" = (/obj/structure/disposalpipe/segment,/turf/closed/wall/mineral/rogue/pipe{dir = 4; icon_state = "iron_line"},/area/rogue/underworld)
"Y" = (/obj/structure/closet/crate/secure/weapon{locked = 0; name = "cyberspace disks crate"},/obj/item/disk/holodisk{name = "SPACE STATION 13"},/obj/item/disk/holodisk{name = "BLACKSTONE"},/turf/open/floor/plasteel/maniac/damaged,/area/rogue/underworld)
"Z" = (/turf/open/floor/plasteel/maniac/damaged,/area/rogue/underworld)

(1,1,1) = {"
eeeeeeeeeeeeeeeeeeeeeeeeeeeeeeeeeeeeeeeeeeeeeeeeeeeeeeeeeeeeeeeneeeeeeeeeeeeeeeeeeeeeeeeeeeeeeeeeeeeeeeeeeeeeeeeeeeeeeeeetWBBBWw
eeeeeeeeeeeeeneeeeeeeeeeeeeeneeeeeeeeeeeeeeeeeeeeeeeneeeeeeeeneeeeeeeneeeeeeeneeeeeeneeeeeeeeeeeeeeeeeeeeeeeeeeeeeeeeeeeePvOZOQP
eeeneeeeeeeeeeeeeeeneeeeeeeeeeeeeeeeeeeeeeeeneeeeeeeeeeeeneneeeeneneeeeeneneeneeeneeeeeneeeeeneeeeeeeeeeeeeeeeeeeeeeeeeeePyDZsHP
eeeeeeeeeeeeeeeeeeeeeeeeeeeeeeeeeeenneeeeeeeeeeeeeneeneneeeeeeneneeeneeeeeeeeeeeeeeeeneeeeeeeeeeeeeeeeeeeeeeeeeeeneeeeeeePrsAsEP
eeeeeeeeeeeeeeeeeeeeeeeeeeeeeeeeeeeeeeeeeeneeeeeneeeeeneeeenneeeeeeeeeeeeneeeeeeeeeeeeeeeeeeeeeeeeeeeeeeneeeeeeeeeeeeeeeePssaDGP
eeeeeeeeeeeeneeeeeeeeeeeeeeeeeneeeeeeeeeeeeeeneeeeeeneeeneneeeneeeneeneeeeeeeeeeeeneneeeeeeeeeeeeeeeeeeeeeeeeeeeeeeeeeeeCTSuzuKT
eeeeeeeeeeeeeeeenneeeeneeeeeeeeeeeeeeeeeeneeeeeeeneeeeeneneeeenneeeeneeeeeeeeeneeeeeeeeeneneeenneeeeeeeeeeeeneeeeeeeeeenePZUVRYP
eeeeeeeneeeeeeeeeeeeeeeeeeeeneeeeeeeeeneeeenneneneeneneeeeeeeeeeeeeeeeeeneeeeeeeeneeneeeeeeneeeeeeenneeeeeeeeeeeeeeeeeeeeIBBXBBN
eeeeeeeeeeeeeeeeeeeeeeeeeeeeeeeeeeeeeneeneneeeeeeeeelllllllllllllleeeeeeeeeeeeeeneneeeeeeeeeeeeeeeeeeeeeeeeeeeeeeeeeeeeeeeeeLeee
eeeeeeeeeeeeeeeeeeeeeeeebbbbbbbbbbbbbeneeeeenebbbbeleeeeebbbbbbbbccccccbbbbbbeeenneneebbbbbbbbbbbbbbbbbeeeeebbbbbbbbbbbbeeeebbbb
bbbbeeeeeeeeeeebbbbbbbbbbbbbbbbbbbbbbbbbbbbbbbbbbbbcbbbbbbbbbbbbbbbbbbcbbbbbbbbbbbbbbbbbbbbbbbbbbbbbbbbebbbbbbbbbbbbbbbbbbbbbbbb
bbbbbbbbbbbbbbbbbbbbbbbbbbbbbbbbbbbbbbbbbbbbbbbbbbbcbbbbbbbdddddbbbbbbcbbbbbbbbbbbbbbbbbbbbbbbbbbbbbbbbbbbbbbbbbbbbbbbbbbbbbbbbb
bbbbbbbbbbbbbbbbbbbbbbbbbbbbbbbbbbbbbbbbbbbbbbbbbbbcbbbbbbbdfjdbbbbbbbcbbbbbbbbbbbbbbbbbbbbbbbbbbbbbbbbbbbbbbbbbbbbbbbbbbbbbbbbb
eeeeeeeeeeeebbbbbbbbbbbbbbbbbbbbbbbeeeeeebbbbbbbbbbleeebbbbbkkbbbbbeeelbbbbbbbbbbbbeeeeeeeeeeeebbbbbbbbbbbbbbbbbbbeeeeeeebbbbeee
nnnnnnnnnnnnnnnnnnnnnnnnnnnnnnnnnnnnnnnnnnnnnnnnnnnnnnnnnneekkennnnnnnnnnnnnnnnnnnnnnnnnnnnnnnnnnnnnnnnnnnnnnnnnnnnnnnnnnnnnnnnn
nnnnnnnnnnnnnnnnnnnnnnnnnnnnnnnnnnnnneeeneeeeeeeeeenneeeeeeekkeeeeeenneeeeeeeeeeeeneeeeeeeennennnennennneeeeoennnnneeeeeenneeeen
nnnnnnnnnnnnnnnnnnnnnnnnnnnnnnnnnnnnneeeeeeeeeeeeeenneeeeeeekpgeeeeenneeeeoeeeeeeennneeeeennnnnnnennnnnneeennnnneeeeennnnnneeeen
nnnnnnnnnnnnnnnnnnnnnnnnnnnnnnnnnnnnneeeeeneeennneenneeeeeeekkeeeeeenneeeeennnnnneeeeeeeeennnneeeeeeeeeeeenneeeeeeeneennnnneeeen
neeeeeeeeeeeeeennnnneeeeeeeeeeeeeeeeeeeeeeeeeeeeeeenneeeeeeheieheennnneennnneeeeeennnneeeeeeeeeeeeeeeeeeeenneeeeeeeeeeneeeeeeeen
neeeeeoeeeeneeeeeeeeeeeeeeeeeeeeeeeeeeenneeeeeeeeeennnneeeeeeeeeeenneeeennneeeeeeennnneeeeeeeeeeeeeeeeeeeeeeeeeeeeneeeeeeeneeeen
neeeeeeeeneneeeeeeeeeeeeeeeeeneeeeeeeeeeeeeeeeeeeeeeeenneeeeeeeeeennenneeeeeeeeeeeeeeeeeeeeeenneeeeeeeeeeeeeeeeeeeeeeeeeeennnnen
neeeeeeeeenneeeeeeeeeennneeennneeenneeneeeeeeeneeeeeennneeeeeeeeeeneenneeeeeeeeeeeeeeeeeeeeeeeeeeeeeeeeeeenneeeeeeeeeeeeeennneen
neeeeeeeeeeeeeeeeeneeeeeneeeeeeennennnnnnneeeeeeeeeeennnneeeennnnnneneeeeeeeneeeeeeeeeeeeeeeeeeeeenneeeeeenneeeeeeeeennnnnnnnnen
neeeeeeeeenneeeeeeeeeeeeenneeeeonneeeeennneeeeeeeennnnnnneeeeeennnnenenneeeeenneeeeeeeeeennneeeeeenneeeeeenneeeeeeeennnnneeeennn
neeeeeeeeeeeeneeeeneeneeennneeeenneeeeennnnnnnnnnnnnnnenneeeeeeeeeneneeeeeeeenneeeeenneeennneeeeeeeeeeeeeeennneeeeeenneeeeeeennn
neeeeeeeeeenneeeeeeeneeeeneeeeeennneeeeennnnnnnneeeeeeenneeeeeeennneenneeeeeeeneeeeenneeennneeeeeeenneeeeeeennnneeeeeeeeeeeeeenn
neeeeeeeneeeeeeeeeeeeeeeennnnnneeeeeeeenneennneeeeeeeeennneeeeeeenneeeeeeeeeeenneeeenoeeennneeeeeeenneeeeeeeeenneeeeeeeeeeeeeenn
neeeeeeeeeeeeeeeeeneneenenneeeeeeenneenneeeeneeeeeeeeeenneeeeeeeenneeeeeeeeeeenneeeeneeeennneeeeeeeeeeeeeeeeeenneeeeeeeeeeeeennn
neeeeeeeeeeeeeeeeeeeeeeeeeeeeeeenneeeenneeneeeeeeeeeeeennneeeeeeennneeeeeeeenneeeeeeeneeeeeeeeeeeeeeeeeeeeeeeeeeenenneeeeoeennnn
neeeeeeeeeeeeeeeeeeeeeeeeeeeeeeeeeeeeeneeeeeeeeeeeeeeeenneeeeeeeenneeeeeeeeeeeeeeeeeeneeeeeeeeeeeeeeennonnneeeeeenenneeeeeeeneen
neeeeeeeeeeneeeeeeeeeeeeeeeeeeeeeeeeeeenneeeeeeeeeeeneenneeeeeeeenneeeeeeeeeeeeenennnneeeeeeeeeeeeeeennnnneeeeeennenneeeeeeeeenn
neeeeeeeeeeeeeeeeeeeeeeeeeeeeeeeeeeeeeeeeeeeeeeeeeeeeeennnnnllllnnneennnnneeeeeeeennneeeeeeeeneeeeeeenneeeeeeeeennenneeeenneeenn
neeeeeeeeeeeeeeeneeeeeeeennneeeeeeeeeeeeeeeeeeeeeeeenneeennneeeeeeeeennnnneeeeeeeennneeeeeeeeneeeeeeenneeeeeeeeenneeeeeenneeennn
neeenneeeeeeeeeeeeeeeeeeennneeeenennnnneeeeeeeeeeeenneeeeeeeeeeeeeeeeeennnneeeeeeennnenneeeeeeeeeeeeenneeeeeeeeenneeeennneeeennn
neeenneeneeeeeeeeeeeeeeeennneeeenennnnneennneeeneeenneeeeeeeeeeeeeeeeeennnneeeeeeeeeeeeeeeeeeeeeeeeeeeeeeeeeenneeeeeeeeeeeeeennn
neeeeeoeeeeeeeeeeeenneeeeeeeeeeeeeeeeeeeeeeeeeeeennnnneeeneeeeeeenneeneeeeneeeneeeeeeeeeeeeeeeeeeeeeeeeeeeeeenneeeeeeeeeeeeennen
neeeeeeeeeeeeeeneeeeeeeeeeeeeenneeeeeeneeeeeeeeeeeeeneeeeeeeeeeeenneeneeeeeneeeeeeeeeeeeeeeeeeeeeennneeeeeeeenneeeneeeeeeeeennen
neeennnnneeeeeeeeeeeennnnneeeenneeeeeeneeeeeeeeeeeenneeeeeeeeeeeeeeneeneeeeneeeeeeeeeeeeeeeeeeeeeeenneeeenneeeeeeeeenneeeennneen
neennnnnneeeeeeeeeeeennnnneeeeeeeeeeeeeeeoeeeeeneeenneneeeeenneeeeeneenneeeneeennnnenneeeeeeeeeeeeeeeneeeeeeeeeeeeeeennnnnnneeen
neennneeeeeeeeeeeeeeeeeeeeeeeeeeennneeeeeeeeeeeneeeneeeeeeeenneeeeeneeeeennneeennnnenneeeeeeeeeeeeeeeenneeenneeeeeeeeeeeeeeeeeen
neeeeeeeeneeeeeeeeeeeeeeeeeeeeeeennneeeeeeeeeeeeeeeennneennnnneeeeeeeeeeennenneeeeeeeeeeenneeeenneeeeennneeeeeeeeeeeeeeeennnnnen
neeeeeeeeneennnnnneeeeeeeeeeeeeeennneeeennneeeeneeeeeeeeennenennneeeeeeeneeeeeeeeeeeeeeeenneeeenneeeeeenneeeeeeenneeeeeeennnnnen
neeeeenneeeeeeeeeeeeeeeeeeeeeennnnnneeeeennneeeneeennneeeeeeeeeeeeeeeeeeeeeeeeeeeeeeeeeeeeeeeeeeeeeeeeenneeeeeennnneeeeeennnnnen
neeeeenneeeeeeeeeeeeeeeeeeeeeennnnnneeeeeenneeeeennnnneeeeeeeeeeeeeneeeeeeeeneneeeeeeeennoeeeennneeeeeeeeeeneeennnneeeeennnnnnen
neeeeeennnenneeeeeeennnneennneeeeeeeeeeeeeenneneeeennneeeeeeeeeeeeeneeeeeeeeeennneeeeeennnnneennneeeeeeeeeennnnnnnneeeeeennnneen
nnneeeeennenneeeeeeennnneeeeeeeeeeeeeeeeeeeeeneeeeeennenneeeeeeeeeeeeeeeeeeeeeenneneeeeennnneeeeeeeeeeeeeeeennennnneeeeeenneeeen
nnneeeeeeeeneeeeeeenneeneeeeeeeeeeeeeeeeeeeeenneeeeeeeenneeeeeeeeeeeeeeeeeeeeeeeeennnneeeeeeeeeeeeeeeeeeeeeeeeeeeeeeeennneeeenen
nnneeeeeeeeneeeeeeeeeeeeeeeeeennnneeeenneeeeeenneeeeeeenneeeeeeeeeeeeeeeeeeeeeeeeeeeeneeeeeeeeeeeeeeeeeeeeeeenneoeeeeennneeeenen
neeeeeeeneeeeeeneeeeeeeeeeeeeeennneennneeeeeeennneeeeeeeeneeeeeeeeeeeeeeneeeeeeeeeennneeeeeeeenennnennenneeeenneeeeenneeeeenneen
neeeeneeneeeeeeeeeeeeeeeeeeeeeeeeeeennneeeeeeeenneeeeeeeennnnneeeeeeeeeeneeeeeeeeeenneeeeeeenneeeeeeeeeeeeeeenneeeennneeeeenneen
neeeeeeeeeeeeeeeeeeeeeeeeeeeneeeeeeennneeeenneeeneeeeeeeeeeeenneeeeeeenneeeeeeeeeeenneeeeneennnnnneeneeneeeeeennneennnennnnnneen
neeeenneeeeeeeeeeenneeeeeeeeneeeeeeeeeeeeeenneeenneeennneeeeennneeeeennneeeeeeeeeeeneeeeeneennneeeeenneneeeeeeeeeeeeeeennnnneeen
neeeenneeeeeeenneeenneeeeeeeeeeeeenneeeeeeenneoeeneeennneeeeeeeeeeeeennneeeeeeeeeenneeeeneennneeeeeeeneneeeeeeeneeeeeeeeeeeeeeen
neeeenneeeennnnneeenneeeenneeeeeeennnnneeeeeeeeeeneeenneeeeeeeeeeeeeeneeeeeeeeeeeenneeeennnnneeneeeeeeeeneeeeeeeeeeeeeeeeeeeeeen
neeeeeeeeeeeeenneeeeeeeeenneeeeeeeeennnneenneeeeeneeeeeeeeeeeeeeeeeneeeeeeeeeeeeennneeeeeeeeeeeeeeeeeeeeneeeeeeeeeeeeeeeeeeeeeen
neeeeeeeeeeeeeeeeeeeeeeeeeeeeeeennneeennnenneeeeeneeeeeeeeeeeeennnneeeeeeeeeeeeenneeeeeeeeeeeeeeeeeeennneeeeeeeeeeeeeeeeeeeeeeen
neeeeeeeneeeeeeeeeeeeeeeeeeeeeeennneeeeneeeeeeeeeennnnnneeeeeeennnneeeeennneeeeenneeeeeeeeeeneeenneeennneeeeeeeeeeeeeeeeeeeeeeen
neeeeeeeeeeeeeeeeeeenennnneeeeennneeeeeeeeeeeeeeeennnnnneeeeeeneeeeeeeeennneeeeenneeeeeeeeeennnnneeeeeeeeeeeeeeeeeeeeeeeeeeneeen
neennneeeenneeeeeeeeeennneeeeeennneeeeeeeeeeeeeeeeeeeeeeeeeeeeeeeeeennnnnnneeeeenneeeeeeeeeeeeeeeeeeeeeeeeeeeeeeeeeeeeeeeeeneeen
nnnnneeeeenneeennneenennneeeeeennneeenneeeeeeeeeeeeeeeeeeeeeeeeeeeennnnnnnneeeeenneeeeennneeeeeeeeeeeeeeeeeennneeeeeeeneeeeneeen
nnnnneeeeeeeeeeeeeeeeeeeeeeeeeennneeenneeneeeneeeeeeeeeeeeeeeeneeeenneeeeeeeeeeeneenneennneeeeeeeeeeeeeeeeeeneeeeeeeeenneneneeen
nnnnneeeeneeeeeeeeeeeeeeeeeeeeeeeeeeeeeeneeeeeeeeeeeeeeeeeenneneeennneeeeeeeeeeeeeeeeeeeeeeeeeeeeeeeeneeeeeeneeeeeeeennnnnneeeen
nneeeeeeeeneeeeeeeeeeeeeeeeeeeeeeeeeeeeeneeeeeeeeeeeeeeeeeennennnnnneeoenneeeeeeeeeeeeeeeeeeenneeennnneeeeeeeeeeenneeneeennnneen
nneeeneeeeeeeeeeeeeeeeeeeeeeeeenneeeeeeneeeeeeeeneeeeeeeeeennnnnnnnneeeenneeeeeeeeeeeeeeeeeeenneennnneneeeeeeeeeeeeeneeoeeeeeeen
nneeeeeeeeeeeennneeennnnneeeeeeeeeeeeeenneeeeeeeeeeeeeeeeeennnnnnnnneeeenneeeennnnnneeeeeeeeeeeenneennneeeeeeeeeeeeenneeeeeeeeen
nneeeeeeeeeeeennneeennnnneenneeeeeeeeeenneeeeeeeeeeeeeeeeeeeeeeeeneeennnnneeeennnnnnneeeeeeeeeeenneeeeeeeeeeeeeeeeeeeeeeeeeeeeen
nneneeeennnnnennneeeeeeeeeeeeeeeenneeeenneeeeeeeeeeeeeeeeeeeeeeeeeeeeeeeeeeeeeeeeennneeeeeeeeeeeeeeeoenneeeeeeneeeeeeeeeeeeeeeen
nneeeneennnnneneeeeeeeeeeeeeeeeeenneeeeeneeeeeeeeeeeeeeeeneeeeeeeeeeeeeeeeeeeeeeeeeenneeeeeeeeeeeeeeennneeeennneeeeneeeeeneeeeen
nnneeeeeeeeeeeeeeenneeeeeeeeeeeeeeeeeeeeeeeeeeeneeeeeeenneeeeeeennnnneeeeeeeeeeeeeeenneeeeeeeeeeeeeeeneeeeeeeeeeenneeennnneeeeen
neeeeeeeeeeeeeeeeeeeeeeeeennnnneeeeeeeeeeeeeeeenneeeeeennnneeeeeeennnnnneeeeeeeeennneenneeeneeeeeeeeeeeennneeeeeeennnneenneeneen
neeeeeeeeeeenneeeeeeeeeeeennnnneeeeeeeeeeeeeeeennneeeeeeennnneeeeeeeeeeneeeeeeeeennneeennnnnnneeeeeeeeennneeeeeeeeeeeeeeneeeneen
neeeeeeneeeenneeeeeeeennnennnnneeeeeeeeeeeeeeeeennneeeeeeennnneeeeeeeeennneennneeeeeeeennnnnnnnnnneeeeeennnnnneeeeeeeeeeeeennnnn
neeeeeeeeeneeeennnneeennneeeeeeeeeeenneeeeeeeeeeeeneeeeeeeeennnneeeeeeeeeeeeeeeeeeeeeeennnnnnennneeeeeeeeeeeeeeeeeeeeeeeeeeeennn
nenneeeeeeneeeennnneeeeeeeeeeeeenneenneeeeeeeeeeeenneeeeeeeeeenneeeeeeeeeeeeeeeeeeeeeeeennennnneeeeeeeeeeeeeeeeeeenneeeeeeeennnn
nenneeeeeeneeeeeeeeeeeeeeeeeeeeenneeeeeenneeeeeeeennneeeeeeeeeeenneeeeeeeeeeeeeeeeeeeeeeennnneenneeeeneeeeeeeeeeeeeeeeeeeeeennen
nenneeeeeeneeeeeeeeeeeeeeeeeennneeeeeennnnneeeeeeennneeeeeeeeeeenneeeeeeeeeeeeeeeeeeeeeeeeennneeneeeeneeeeenneeeeeeeeeeeeeeeeeen
nenneeeeeeneeeeeeeeeeeeeeeeeennneeeeeennnnneeeeeeeeeeeeeeeeeeeeeeneeeennneeeeeeeeeeeeeeeeeeeeeeeeeeeeeeeeeeeennneeeeeeeeeeeeeeen
neneneeeeennnneeeeeeeeeeeeeennnnenneeeeeeeeeeeeeeeeeeeeeennnneeeennnnneeeeeeeeeeeeeeeeeeeeeeeeeeeeeeeeeeeeeeeeennneeeeeeeeeeeeen
neeeneeeeeennneeeennnnneeeeeeeeeeeeeeeeeeeeeeeeeeeeeeeeeeennnnnnnnneeeeeeeeeeeeeeeeeeeeeeeeeeeeeeeeeeeeeeeeeeeeeeeeeeeeeeeeeeeen
neeennnnneeeeeenneeeeeeeeeeeeeeoeeeeeeeeeeeeeeeeeeeeeeeeeeeennnneeeeeeeeeeeeeeennneeeennnnnneeeeeeeeeeeeeeeeeeeeeeeeeeeeeeeeeeen
neeeennnneeeeeeeeeeeeeeeeeeeeeeeeeeeennnnnnenneeeeeeeeeeeeeeonneeeeeeeeeeeeeeeennneeeennnnnnnnneeeeeeeeeeeeeeeeeeeeeeeeeeeeeeeen
neeeennnneeeeeeeeeeeeeeeeennnneeeeeeneeeeeeenneeeeennneeeeeeenneeeeeeeeeenneeeeenneeeennnnneenennneeeeeeeeeeeeeeeeeeeeeeeeeeneen
neeeennnnnneeeeeeennnneeenneeeeeeeeeeeeeeeeeeeeeeennnneeennnnneeeeeeeeeeenneeeeenneeeeeeeeeeeneeenneeeeeeeeeeeeeeeeeeeeeeeenneen
neeeennnnnneeeeneeeeeeeeenneeeeeeeeeeeeeeeeeeeeeeeneeeeeeeeeeeeeeeeeeeenneeeeeeeeeeeeeeeeeeeeeeeeeeeeeeeennneeeeeeeeeeeeeeeneeen
neeeennnnnnneeeneeeeeeeeenneeeeeeeeeeeeeeeeeeeeeenneeeeeeeeeeeeeeeeeeenneeeeeeenneeeeeeeeeeeeeeeeeeeeeeennneeeeeeeeeeeeenenneeen
neeneeeeeeeeeeeeeeeeeeeeennnnnneeeeeeeeenneeeeeeenneeeeeeeeeeeeeeeeeeenneeeeeeenneeeenneeeeeeeeeeeenneeenneeeeeeeeeeeeennnnneeen
neeeeeeeeeeeenneeeeeeeeeeeennnneeeeeeeeeeeeeeeeeeneeeeeeeennnnneeeeeeeneeeeeeeenneeeeennneeeeeeeeeeeeeeeeeeeeeeeeeeeeeeneeeeeeen
neneeeeeeeeeenneeeeeeeeeeeeeeeeeeeeeeeeeeeeeeeeeeeneeeeeeennneeeeeeeeeenneneenneeeeeeennnneeeeeeeeeeeeeeeeeeeeeeennnnnennnneeeen
neneeeeeeeeeeeeeeeeeeeeeeeeeeeeeeeeeeeeeeeeeeeeeeeeneeeeeeeeeeeeeeeeeeenneneeeeeeeeeeeeeennneeeeeeeeeeeeeeeeennnnneeeeeeeeeeeeen
neeennneennnneeeeeeeeeeeeeeeeeeeeeeeennnneeeeeeeeeeneeeeeeeneeeeeeeeeeeeeeeeeeeeeeeeeeeeeennnneeeeeeeeeeeeeeeeeeeeeeeeeeeeeeeeen
nenneeeeennnneeeeeeeeeeeeeeeeeeeeeeeneeeeeeeeeeeeeeeeneeeeeneeeeeeeeeeeeeeeeeeeeeeeeeeeeeeeenneeeeeeeeeeeeeeeeeennnneeeeeeeeeeen
neenneeeeeeeeeeeeeeeeeeeeeeeeeeeennnneeeeeeeeeeeeeeeeeeeeenneeeeeeeeeeeeeeeeeeeeeeeeeeeeeeeeeeeeeeeeennnnneeeeeeeeennneeeeeeeeen
neeeeeeeennnneeeeeeeeeeeeeeeeeeeennneeoeeeeeeeenneeeeeeeeeneeeeeeneeeeeeeeeeeeenneeeeeeeeeeeneeeeeeenneeeeeeeeeeeeeeenneeeeeeeen
neeeeeeeennnneeeeeeeeeeeeeeeeeeeeeeeeeeeeeeeeeeennneeeeeeeeeeeeeeneeeeeeeeeeeennneeeeeeeeeeeneeeeeeneoeeeeeeeeeeeeeeeeeeeeeeeeen
neeeeeeeeeeeeeeeeeeeeeeeennnneeeeeeeeeeeeeeeeeeennneeeeeeeeeeeeeenennneeennnnenneeeeeeeeeeeeeeeeeeeneeeeeeeenneeeeeeeeeeeeeeeeen
neeeeeeeeeeeeeeeeeenneeeeeenneeeeeeeeeeeeeeeeeeenneneeeeeeeeeeneeeeeeeeeeeeeeeneeeeeeeennneeeeeeeeeeennneeeennnneeeeeeeeeeeneeen
nenneeeeeeeeeeeeeenneeeeeeeeeeeeeeeeeenneeeeeeennnnneeeeeeeeennneeeeeeeeeeeenneeeeeeennenneneeeeeeeeenneeeeeeeeeenneeeeeeeeneeen
neeeeeeeeeeeeeennnnneennneeeeeeeeneennnneeeeeeeennneeeeenneeennneeeeeeeeeeeenneeeeeeeeeenneneeeeeeeeeeeeeeeeeeeeeeeeeeeeeeeeeeen
neeennnnennneeennneeeenneeeeeeennnnnnnnnneeeeennnnneeeeeneeeeeeeeeeeeeeeeeeeneeeeeeeeeeeeenneeeeeeeeeeeeeeeeeeeeeeeeneeeeneeeeen
neeeeeeeeenneeennneeeenneeeeeeennnnnnneneeeeeennneeeeeeneeeeeeeeeeneeeeeeeeeeeenneeeeeeeeeeeeeenneeeeeeeeeeeeenneeeenneenneeeeen
neoeeeeeeeeeeneeeeeeeenneeeeneennnnnnneneeeeeeeeeeeeeeeneeeeeeeeenneeeeeeeeeeeennnnnneeeeeeeeeenneeeeeeeeeeeeenneeeeenneneeeeeen
neeeeeeeeeeeeneeeeeeennneeeeeeennnnnnnnenneeeeeeeeeeeeeneeeeeneeenneeeeeeeeeeeeeennnnnneeeeeeeeeennnneeeeeeeeeeeeneeeennneeeeeen
neeeeeeeeeeeeeeeeeeeennneeeeeeeeennnnneeeneeeeeeeeeeeeeneeeeeeeenneeeeeeeeenneeeeeeeeeneeeeeeeeeeeeenneeneeeeeeenneeeeeeeeneeeen
neeeeeeeeeeeeeeeeeeeeeennneeeeeeeeeenneeeeeeeeeeeeeeeeeeeeeeeeeenneeeeneeeennneeeeenneeeeeeeeeeeeeeeeeeennneeeeeeeeeeeeeeenneeen
neeeeeeeeeeeeeeeeeeeeeeeeeeeeeeeeeenneeeeeeeeennnneneeeeeeeeeennneeeeenneeeennnenneeeeeeeenneeeeeeeeeeeeeeeeeeeeeeeeennneeeneeen
neeneeeeeeeeeeeeeeeeeeeeeeeeeeeeeeenneeeeeeeeeennneneeeeeeeeennneeeeeenneeeeeenneeeeeeeeeeennneeeeeeeeeeeeeeeeeeeeeeeneeeeeeeeen
neeeeeeeeeeeeeeeeeeeeeeeeeeeeeeeeeeeeeeeeeeeeeeeeenneneeeeennneeeeeeeennneeeeeeeeeeeeeeeeennneeennneennneeeenenneeeeennneeeeeeen
neeneeeeeennneeeeeeeeeeeeeeeeeeeeeeeeeeeeeeeeeeeeeeennneeeeeeeeeeeeeeenneeeeeeeeeeeeeeeeeeneeeeeeneeeeennnnnneeeeeeeenennneeeeen
neeneeeeeennneennnnneeeeeeeeeeeennneeeeeeeeeeeeeeeeeenneeeeeeeeeeeeeeennneeeeeeeeeeeeeeeeeeeeeeeeeeeeeeeeeeeeeeeeeeeeeneenneeeen
neeneennneeeeeeeeeeeennneeeeeeenneeeeeeeeeeeeeeeeeeeenneeeeeeeeeeeeeeennnneeeeeeeeeeeeeeeeeeeeeeeeeeeeeeeeeeeeeeeeeeeenneennneen
neeneennneeeeeeeeeeeeeeeeeeeeeenneeeeeeeeeeeeeneeeeennneeeneeeeeeeeeeeneeneeeeeeeeeeeeeeeeeeeeeeeeeeeeeeeeeeeeeeeeeeeeenennennen
neeeeeeeeeeeeeeeeeeeeeeeeeeeeeeennnneeeeeeeeeeneeeeennneeeennnnnenneeennnneeeeeeeeeeeeeeeneeeeeenennnnnneeeenneeeeeeeeeeeennenen
neeeeeeeeeeennneeeeeeeeeeeeeeeeeennneeeeeeeeenneeeeennneeeeeeeeennneeeeeeeeeeeeoeneeeeeeennnennnneeeeeeeeeeeeeeeeeeeeeeeeeeennnn
neeeeeeeeeeennneeeeeeeeeenneeeeeeeeeneeeeeeeenneeeennnneeeeeeeeeeeeeeeeeeeeeneeenneeeeeeeeeeeeeeeeeeeeeeeeeeeeeeeeeeeeeeeeeeeenn
neeeeeeeeeeeneeeeeeeeeeeenneeneeeeeeeeeeeennneeeeeeeeeeeeeeeeeeeeeeeeeeeeeeeennnneeeeeeeeeeeeeeeeeeeeeeeeeeeeeeeeeeeenneeeeeeeen
neeeeeeeeeeeeeeeeeeeeeeeeeeeeneeeeeeeeeennnnneeeeeeeeeeeeeeeeeeeeeeeeeeeeeeeeeeeeeeeeeeeeeeeeeeeeeeeeeenneeeeeeeeeeenneeeeeeeeen
neeenneeeeeeeeeeenneeeeeeeeeeeeeeeeeeeeenneeeeeeeeeeeeeeeeeeeeeeeeeeeeeeeeeeeeeeeeeeeeeeeeeeeeeeeeeeennneeeeeeeeeeenneeoeeeeeeen
neeenneeeeeeeeeeenneneeeeeeeeeeeeeeeeeeenneeeeeeeeeeeeeeeeeeeeeeeeeeneeeeeeeeeeeeeeeeeeeeeeeeeeeeeeeeennnneeeeeeeeeeeeeeeeeeeeen
neeeeeeeeeeeeeeeeeeeneeeneeeeeennneeeneeeeeeeeeeeeeeeeeeeeeeeeeeeneeneeeeeeeeeeeeeeeeeeeenenneeeeeeeeeeeeeeeeeennneeeeeeeeeeeeen
neeeeeennneennneeeeeneeeneeeeeeeeeeeeeeeeeeeeeeeeeeeeeeeeeeeeeeenneeeeeeeeeeeeeeeeeeeeeeennneeeeeeeeeeeeeeeeeeeeeeeeeeeeeeeeeeen
neeeeeeeeeeeeeeeeeeeneeeeeeeeeeeeeeeeeeeeeneeeeeeeeeeeeeeeeeeoenneeennnnnnenneeeeeenneeeeeeeeneeeeeeeeeeeeeeeeeeeeeeeeeeeeeeeenn
nennneeeeeeeeoeeeeeeneeeeeenneeeeeeeeeneeenneeeeeeeeeeeeeeeeeeeeeeenneeeeeeeeennennneeeeeeeeenneeeeeneeeeeeeeeeeeeeeeeeeeeeennnn
nennneeeeeeeeeeeeeeeneeeeeenneeeeeeeeeeneenneeeeeeeeeeeeeeeeeeenneennnnneeeeeeennnneeeeeeeeeeennnennneeeeeeeeeeeeeeeeeeeeenenenn
neeeeeeeenneeenneeeeneeeeeenneennnneennnneeeeeeeeeeeeeeeeeeeeeeennnneeennnnnnnnneenneeeeeeeeeenenenneeeeeeeeeeeeeeeeeeeeennnennn
nennnneeeeennnnnennnnnnnnnneeeennnneennnneeeeeeeeeeeeeeeeeeeeeeeeeeeeeeeeeennneeeeeeeeeeeeeeeennnnneeeeeeeeeeeeeeeeeeeeenneeenen
neeeeeeeeeennnnnennnnnnnnneeeeeeeeennnnnneeeeeeeeeeeeeeeeeeeeeeeeeeeeeeeeeeeenneeeeeeeeeeeeeeeennnneeeeeeeeeeeeeeeeeeennnnennnnn
neeeeeeeeeeeeeeeeeennnneneeeeeeeeeeeeeeeeeeeeeeeeeeeeeeeeeeeeeeeeeeeeeeeeeeeeeeeeeeeeeeeeeeeeeeeeeeeeeeeeeeeeeeeeeeeeeneeeennnnn
nnnnnnnnnnnnnnnnnnnnnnnnnnnnnnnnnnnnnnnnnnnnnnnnnnnnnnnnnnnnnnnnnnnnnnnnnnnnnnnnnnnnnnnnnnnnnnnnnnnnnnnnnnnnnnnnnnnnnnnnnnnnnnnn
"}
