"a" = (/turf/closed/mineral/rogue,/area/rogue)
"b" = (/obj/effect/decal/cleanable/blood/gibs,/obj/effect/decal/cleanable/blood/gibs/limb,/obj/effect/decal/cleanable/blood/old,/obj/effect/decal/cleanable/blood/tracks{dir = 9},/turf/open/floor/rogue/cobble,/area/rogue)
"f" = (/obj/machinery/light/rogue/torchholder/l,/turf/open/floor/rogue/cobble,/area/rogue)
"n" = (/mob/living/carbon/human/species/skeleton/npc,/turf/open/floor/rogue/cobble,/area/rogue)
"o" = (/turf/open/floor/rogue/cobble,/area/rogue)
"r" = (/obj/structure/fluff/walldeco/chains,/turf/open/floor/rogue/cobble,/area/rogue)
"s" = (/obj/effect/decal/cleanable/cobweb/cobweb2,/obj/structure/rack/rogue,/obj/effect/spawner/lootdrop/roguetown/sewers,/turf/open/floor/rogue/cobble,/area/rogue)
"v" = (/obj/structure/spider/stickyweb,/obj/structure/spider/stickyweb,/turf/open/floor/rogue/cobble,/area/rogue)
"w" = (/obj/structure/mineral_door/wood/red,/turf/open/floor/rogue/cobble,/area/rogue)
"C" = (/obj/effect/decal/cleanable/blood/tracks{dir = 6},/turf/open/floor/rogue/cobble,/area/rogue)
"D" = (/obj/effect/decal/cleanable/cobweb,/obj/structure/rack/rogue,/obj/effect/spawner/lootdrop/roguetown/sewers,/turf/open/floor/rogue/cobble,/area/rogue)
"F" = (/mob/living/simple_animal/hostile/retaliate/rogue/bigrat,/turf/open/floor/rogue/cobble,/area/rogue)
"G" = (/obj/effect/decal/cleanable/cobweb,/obj/structure/fermenting_barrel/beer,/turf/open/floor/rogue/cobble,/area/rogue)
"H" = (/obj/effect/decal/cleanable/blood/gibs/up,/obj/effect/decal/cleanable/blood/gibs/limb,/obj/effect/decal/cleanable/blood/old,/obj/effect/decal/cleanable/blood/tracks,/turf/open/floor/rogue/cobble,/area/rogue)
"I" = (/obj/machinery/light/rogue/torchholder/r,/turf/open/floor/rogue/cobble,/area/rogue)
"P" = (/obj/effect/decal/cleanable/blood/tracks,/turf/open/floor/rogue/cobble,/area/rogue)
"Q" = (/obj/structure/fermenting_barrel,/turf/open/floor/rogue/cobble,/area/rogue)
"R" = (/turf/closed/wall/mineral/rogue/stonebrick,/area/rogue)
"U" = (/obj/structure/closet/crate/chest,/obj/effect/spawner/lootdrop/roguetown/sewers,/turf/open/floor/rogue/cobble,/area/rogue)
"W" = (/obj/structure/fermenting_barrel/random/water,/turf/open/floor/rogue/cobble,/area/rogue)
"X" = (/obj/structure/spider/stickyweb,/turf/open/floor/rogue/cobble,/area/rogue)
"Y" = (/obj/effect/decal/cleanable/blood/tracks{dir = 8},/turf/open/floor/rogue/cobble,/area/rogue)
"Z" = (/obj/structure/fermenting_barrel/random/water,/turf/closed/wall/mineral/rogue/stonebrick,/area/rogue)

(1,1,1) = {"
RRRXRRRRRRRRRR
RaRvRaaaaaaaaR
RaRoRaRRRRRRaR
RaRXRRRGrQsRaR
RRRowooooooRRR
XXoXRRRooHowXX
RRRRRaRonPIRRR
RaaaaaRooCoRaR
RaaaaaRoooURaR
RaaaaaRRwRRRaR
RaaaaaaRoRaaaR
RaRRRRRRoRaaaR
RaRDQQoroRaaaR
RRRoFooooRaaaR
XXwoobYCoRaaaR
RRRfoooooRRRRR
RaRooooFowXXXX
RaRUUoooWZRRRR
RaRRRRwRRRaaaR
RaaaaRXRaaaaaR
RRRRRRXRRRRRRR
"}
