"c" = (/mob/living/carbon/human/species/skeleton/npc,/turf/open/floor/rogue/cobble,/area/rogue/under/town/sewer)
"d" = (/obj/effect/decal/cleanable/cobweb,/obj/structure/rack/rogue,/obj/effect/spawner/lootdrop/roguetown/sewers,/turf/open/floor/rogue/cobble,/area/rogue/under/town/sewer)
"e" = (/obj/effect/decal/cleanable/cobweb,/obj/structure/fermenting_barrel/beer,/turf/open/floor/rogue/cobble,/area/rogue/under/town/sewer)
"f" = (/obj/structure/fermenting_barrel/random/water,/turf/open/floor/rogue/cobble,/area/rogue/under/town/sewer)
"h" = (/obj/structure/fermenting_barrel,/turf/open/floor/rogue/cobble,/area/rogue/under/town/sewer)
"i" = (/obj/effect/decal/cleanable/blood/tracks,/turf/open/floor/rogue/cobble,/area/rogue/under/town/sewer)
"k" = (/obj/effect/decal/cleanable/blood/tracks{dir = 8},/turf/open/floor/rogue/cobble,/area/rogue/under/town/sewer)
"m" = (/obj/structure/mineral_door/wood/red,/turf/open/floor/rogue/cobble,/area/rogue/under/town/sewer)
"n" = (/mob/living/simple_animal/hostile/retaliate/rogue/bigrat,/turf/open/floor/rogue/cobble,/area/rogue/under/town/sewer)
"o" = (/turf/closed/wall/mineral/rogue/stonebrick,/area/rogue/under/town/sewer)
"r" = (/obj/machinery/light/rogue/torchholder/r,/turf/open/floor/rogue/cobble,/area/rogue/under/town/sewer)
"s" = (/obj/structure/fluff/walldeco/chains,/turf/open/floor/rogue/cobble,/area/rogue/under/town/sewer)
"x" = (/obj/effect/decal/cleanable/blood/tracks{dir = 6},/turf/open/floor/rogue/cobble,/area/rogue/under/town/sewer)
"y" = (/turf/closed/mineral/rogue,/area/rogue/under/town/sewer)
"z" = (/obj/structure/closet/crate/chest,/obj/effect/spawner/lootdrop/roguetown/sewers,/turf/open/floor/rogue/cobble,/area/rogue/under/town/sewer)
"B" = (/obj/structure/spider/stickyweb,/obj/structure/spider/stickyweb,/turf/open/floor/rogue/cobble,/area/rogue/under/town/sewer)
"E" = (/obj/effect/decal/cleanable/blood/gibs/up,/obj/effect/decal/cleanable/blood/gibs/limb,/obj/effect/decal/cleanable/blood/old,/obj/effect/decal/cleanable/blood/tracks,/turf/open/floor/rogue/cobble,/area/rogue/under/town/sewer)
"I" = (/obj/structure/fermenting_barrel/random/water,/turf/closed/wall/mineral/rogue/stonebrick,/area/rogue/under/town/sewer)
"O" = (/obj/effect/decal/cleanable/blood/gibs,/obj/effect/decal/cleanable/blood/gibs/limb,/obj/effect/decal/cleanable/blood/old,/obj/effect/decal/cleanable/blood/tracks{dir = 9},/turf/open/floor/rogue/cobble,/area/rogue/under/town/sewer)
"P" = (/obj/machinery/light/rogue/torchholder/l,/turf/open/floor/rogue/cobble,/area/rogue/under/town/sewer)
"Q" = (/turf/open/floor/rogue/cobble,/area/rogue/under/town/sewer)
"W" = (/obj/structure/spider/stickyweb,/turf/open/floor/rogue/cobble,/area/rogue/under/town/sewer)
"Y" = (/obj/effect/decal/cleanable/cobweb/cobweb2,/obj/structure/rack/rogue,/obj/effect/spawner/lootdrop/roguetown/sewers,/turf/open/floor/rogue/cobble,/area/rogue/under/town/sewer)

(1,1,1) = {"
oooWoooooooooo
oyoBoyyyyyyyyo
oyonoyooooooyo
oyoWoooeshYoyo
oooQmQQQQQQooo
WWQWoooQQEQmWW
oooooyoQcirooo
oyyyyyoQQxQoyo
oyyyyyoQQQzoyo
oyyyyyoomoooyo
oyyyyyyoQoyyyo
oyooooooQoyyyo
oyodhhQsQoyyyo
oooQnQQQQoyyyo
WWmQQOkxQoyyyo
oooPQQQQQooooo
oyoQQQQQQmWWWW
oyozzQQQfIoooo
oyoooomoooyyyo
oyyyyoWoyyyyyo
ooooooWooooooo
"}
